10 10 1
----------
--F-------
XXXX-XXX--
---X------
---XXXX---
--X--GX---
----XXX---
-XXXX---X-
----X-X---
------X---