15 15 1
---------------
---------------
--S----M----P--
---------------
----M-----M----
-------X-------
-------X-------
--M--XXXXX--M--
-------X-------
-------X-------
----M-----W----
---------------
--P----M----G--
---------------
---------------