10 10 1 fairy
----------
--S-------
XXXX-XXX--
---X------
---XXXX---
--X--GX---
----XXX---
-XXXX---X-
----X-X---
------X---