21 21 1
S--------------------
--------------------M
-------M-----------X-
-------------M-----X-
----XXXX-------XP--XX
----XXX---P---XXX----
----XXP--------X-----
--M-X----M-M---------
--------X-X-X--------
-------M-P-P-M-------
-----P--X-X-X--P--M--
-------M-P-P-M-------
--------X-X-X--------
---M-----M-M---------
-----X---------------
----XXX---P----M-----
----PX----------XX--P
----------------XG---
----------M-------W--
--XXX----------------
-M--X-----------P---P