30 11 1
--P-------PP--XXXXMMMMMMMMMMMM
-PP------PP--XXXXXMMMMMMMMMMMM
------------XXXXXXMMMMXXXXXXXM
-----------XXXXXXXMMMMX-----XM
-----PPP--M--XXXXXXXXXX-----XM
-S---PP----M----------W--G--XM
------PP--M--XXXXXXXXXX-----XM
-----------XXXXXXXMMMMX-----XM
------------XXXXXXMMMMXXXXXXXM
-P-P-----PP--XXXXXMMMMMMMMMMMM
-PPP----------XXXXMMMMMMMMMMMM