10 10 1 fairy
----------
-XXXXX----
----------
---S------
---X--XXX-
--XX--X---
----XXX---
-XXXX---XX
----X-X---
------X--G